...#.##..##.#...##.###.#.#.###.##.#.###..#.#......##..#.#..##....#####.....##..#..###..#.##.###..#...##...#.##..######......###.
##..#.....##..##...##.......#....#.#...#...#.#.....#.#.#.....###.##.######..##.#.....###.....##.#..#..###.#.###.#.#.##..#...###.
#..#.###..##..##.##..#...##..#....#.###....###.#.....#...#.###.##.#.###...#..#.###.##.#.#.##..#.....#...#.###..###.#####.#....##
.###..#.##...####..####.#####..#...#.#.##....##..#.#..#..#..#.#..#...##..#.#..##.#...#.#.#.##..#.#####.##.###.###.##...#..#..###
.#.######.#.#.#.......#.##..##..####.##..#.#.#..#...##..##..#.#..#..##...#.##.###.#.#..#...#.##.#.#.##..#..##.##....##.#.#..##.#
##.#.########..#..#...#.##..##.#.#.#.##......#....#.###...###.####.###.......####.#.##....###....##...#....#.##...####.##.......
.....#.#.##........###..##.##...###....#...#..#..##...#.#..#####.##.###.#.#.........#..#..######..##...####....#...###..#..##.##
..#.#...###....#..#.##.#.###..#######..##..#.##.#..##.##..#..##....#..#.###...###.#.....##...####.##.####...##.........####.#..#
#.#..###....##########..##.######.#.###.#.#.####...####.##.#...##.#.....####.....#.##..#.#.#.###..###..###...####.#....#.#...#..
###..##...##.#..###.#..#.##.#......##...#.##.##..##.#.#.###.#.#.##..##.##.#..#...#.####.###...#.#.###..##.#.##..#..####...#...##
#..###.#.##..#...####.#....##....#.####...#####.....#.####...#.##...#.#.###....##.#..##..##..#####..#..##..#.#.##.#.#.##.##.#...
..#..#.....#.####......#...###.#....#...#.#.#.#.##...##.##.##..###...#...#.####.##..##.#...###.##..#..#...###..##..#..##.##.....
###.#.#..#.######...#..####.##.#.#.#..#..#.######.#.##.#.##.#..##.#..#.#.###...#.#..#..##..##..#...##.##.##.####.....#.#.##.##.#
.#.##....#.####...#.###....#..#..##.#...#..#.########...#.#####.##...###.#.##.#.##.....#.###.##..#.##......####..#.##.###.##.#..
##....#.#######..###.###.##...##...##..##...#..#.##.....######..#.#..####.#..##..#######....#.##.#.#.#....#..#..#..#.####.##.##.
#.#..#...##.#..###.##.#.....#..##.###..##...###.###..###.....###..#.##.#..#...#..#.##.#...##..#....####.##.#.##..####.#....###..
####.##.##..###..#.##.....##.###...###.###..#..#.###...##.#.####.#.#..#.#..##.#####..#...#####.##.#.#.#...##....#.####.#..#.#.#.
.####..###.##....#..##.##.#...###.##...#.#..#.#..###.###.###..#.....##.#.....##.##..#..#.#.##.##..#..###..##...#...#.##...#.#...
##.##..#...##.#....##....###....#..##.#.#.#.#####.###.##.#.#...#.#.####.#.#.#.####...##..##.#..#..#...#....##.##..###.#...#.##.#
##...#.#....###.#####..##..#.........##...##....##.#.#######.#.#..#...#####.#.#.#...#.##.#.#.###...#...####.##.#.####.#...#..#.#
...###..####..##.#.####..##.....#.#...#..#.###..#....###......#.#....#####.#..##.####.##..##..#....#..##..#..#.##.#.##.#..#.##..
##..#..###.#.#.###...##...##.##.###.##.##.#.##.#.#....###...##....#....#.##.....#..#.##...##.##..##..##.....##.#.###.####..####.
#...##.##.#..##..######.##.#.....#..##.##.###.########..#.####..#..##..#.##.#.###.#.###.###.##....##.........#..#.######....#...
#......#...#..####.##...#...#.######..#.##.#....#..#...#.#.####....##.....#.###.###.######.#..#.##..#.#.##.####..####..#.#..#.#.
.#.#.#.##.###.#.#.##.#.##...#..###...#.###....##...#..##..##.##.#.#.#####.####...#..#..###.#..#.###.###..#..#.##.##..####.###.#.
#..##.###.##.###.##..#....#.##.#....########.#..#.#....#...##..#.###..##.####..###.##..###.#...##..###..###..#.######.#.#.#..###
.##.#####...#..##.#####..###....####.#..#.####...####.#.#.###.##.#.#....###.####..####...##....#.###.###.##..##.##...####..#.#.#
##.#.#.##.....#..#..###.##...#..##....##.###..#...#.#.###....#.###.#.#...#...#####...#.##.#..#..##.##.#.#..#..#..##.#......#....
#..###..#...####...##.#.#.##..#.#.#..#..##...###.#.###.##....#..###.#####.#.##..#..##.###..##.####..#.###.###..##...#...#.###...
.#..#.#...#.#....#..#.##.#.##.#....##.###...#.##....#.##.##.#.....####..#.####.#####...#.#.##......##....#####..........##..##..
##..##..#..##....###.#.##..#.#.#......#..###.....####.##....#.#........#..###.#..##...#..#####.####..#####....#..#..###.#####...
..#####........#.###.######..##.#...#...#..#..#####..#.###.###.#####....#.#.#####.....#..##....#....#..##..#......##....#..##...
....####....###.#...#...##..####...####.#..#.####.#.#..#.#.####...#.##..#.###...#.##..#..##....##.#..##..###.#.#..####.##..#...#
###.########...#.##.##.###.....#....#...###..##....#.###.###.###.####.#.#.#####..##..###....####....#..#.#####.#####...#...#.#.#
.#........##.#..######.#..#.#.#.##..##.#####..##....#.###.####....#.##...#......#.##.###.##..#.####.#....###.###.#..####.#...#..
##.#...##.#..#...#..#####...###..#.##....##..#.#...##.#...#.#.#..#.#.##....##.#.#.#..##.#.####..##..###.#....#.....#.##.#.##..##
.####.....#...##..###.#..#...#...#...##.#.##..#..##...###.#######.##...#..#.##...#..####...###.#.#...###.#.###.###.....#...##..#
##..#####..#..#.##..##.##..##.##.....#...#.###.#..###.##.##.##.##...#.##.####.#.#.#.##....###.##..###.#..#.#.##.##......##..###.
...##.#.#...#......###.##..#.#..#..#.######.###.#.##.###.....##.#....#.###..##.#.####.##.......#.#..###.#..#.#.#..##.##.....##..
##.##..###....#....###.#..#..#...#.##.#..#..##...###.#...#####.#..##.##.#.#.....#.###..#.#.#..########.#..#.#.#..##.#.########.#
#..#.#..#.#.####.#.#..#.#..####.#.#.#..##.#..####.#.##..#..#...###.#...#######.##....#.##....#.#..##..#.###.#.###..#.##.#.#..###
#.#..#.######....#......##....###.##.##..#.#.#...##.....#.##..#####..##.#.....####.#..#..#...#.##....###.#.#...#.#####.##.##.##.
#..#.#..#####.#.#..#..###..#..###..##.#..###..#..##..#.###..##......###...##..##.#.##.#.#...#.#...##.#..######.######...####..##
.##....#.......##.###.....##..###.#.##.....##.#.....#.#.#......##.##....#.####.###...##..##....##.#........#.#####.###.#...#.##.
.##.###.##.####.##.##.##...#.##..#.#...#.###...#.###.#..##.#..#...#.#.##.#...#.#.#.#..#.#.#.#..##...#.##.####.#.....#.###..#.#..
###.#####....##.#..#..##.#..###.#...###.......#....#.###..#.#..#..#.#...###...###...#....##.####..#.......#.###.#.#...###....###
..##....###.##.###..######.#.....###..##.#.##.####.#....###....##.#.##......#..##.#..##.###.#...##.#.#..#####.#..##..#...####.#.
#.#....#..#..#....#..##.#..#...########.#.##..###.###.###.#.#......##..#...##.#.#.....#...#...###.#.#.#.#.#...###....#.#.#....#.
..##..##.#.....####...##.#..#.##.####...#.....#....#.....##.###..##.#..#..###.###...##..#.#..#..#.#..##.##.###.######.#.#.#..#.#
.#.###.#.#.##.#...#.###..#.#..#.#############.##...###...####...#.#.......####.#..##.##.##.##...###...######.#.#......##.#####.#
#.#.####...##.#.####.##.#.##.##....##..##....##...###.##.#######.##..###..#........#.##.#..#..#.#..###.#.#.###...##..#.#.#..#..#
...##..#...#.#....#.##.##..####.####..###.#....#.######.###.#..###..#.##.#.#...#.#.####..###..##..##.#..####.#########..####..##
#...#...#.#.###.#....#.###..##..#.#..###..#..#..#.#.....##.###.#..##.#..##..#......#.####.....#.#..#.##.#..###.#...##.#####.#...
.#.#.##..##....##...####.##.##.....#.#....#..###..#.###..#.##.#####.#.#..##.#.###.#..##...#.#.###...#####....##.####.###.##.....
.#.###..#.#.#....##.#.....#.##...###.##.#..####..##.#####..##.#.#.#....#.####...###.#..#######.#..#.#.#.#.#..####.###.##.#.#.##.
.##.###.##.##........##.###.#..#.#.##.###.##.##...##.#..#.###...#.....#.##.#....#.....#..###.....#............#..##.#.###.##...#
######.#..#.#########.#........#.#.#...#....#...#.#...###.#..##....###.#..##.##.#...#..#.#.##...#.#....#..#.#....###..#..###.#..
##.##..##.##..##.####.#..##.....#..#####...#######.###.##.##.#.#.#.###.#.#.###.###......#.#.###..#########...#######.#.##.###.##
....##.#..#.#########.##.###..#..#...##.....#..##.###.#......#.#...####..#..##.#.##.##.##.####.#........####.#####.###..####..##
.####.........#.###.##......###.....##..##.#.#####.#....###.#.#...#.##..###..#.########......##......#..........#..#...###.###.#
.#..##......###...##.##.#.#...#.####.......##.##.#####.#####.###.#.#.##.###..#.####.###.......##..##..#.###...###..##..##.#....#
.###.#.#.##..#.....##.#..#...###.....#..#.##.#........####..#.##..#..##..#.#.###.#..##..#.###.##.#.##...#.#.###..#.##.##...#####
...#..###.#......###.##...##.##.#...#.##.#######.##.####.######..#.#....###.###########.###..####..#...#...####.###...#.##.###.#
##.##...#..#..#.#..##.#.#...##.###.##.##.#.###......##.#......##..#.##..#...######.#.#...###.####..###.####..#.#..#.###.#.....#.
.#.##.#....#..#..##.#####...###...#.#...#.#..#..####....#.###.####.#.##.#.#..####.##.#.#..###..####..###..##.#.#.##..##...#..###
..#..#.##...###....##.#..#.###.##..#.#.....#..##.##..##..###.##...##.####..###.###.##.#######..##.##..##.###..###.####..#...####
###..#.#...###.#.#.####...#.#.#.#.#..###.#.##.###.....#.#.....#.##..#..##.#.#.###.#.#######..#.###..#####.####.##...#.###.#....#
......#.#....###..#......#.#.#######.##..####....#....##.#########....#......#.#.#......##########.#.#.##.#....#.###......####..
##....##.#...##.....#....#.##...#.#...####.#...##....######..#####.###.##.#..#.###...##....######.#.#..###...#...#.#.##..#.###.#
#..#.####.#.#.##.####.#.#..##.#######....#..###.#.#####.#..#.#..###..#..#.#....########....##......###.#...#.#.......######.##..
.##....####.#..#.#..##..##..###..#.###..#.###.#.##.##...###.##..##....####.##....#...#....###....#..#.##.##...####.#.##..#.....#
#..###....#....#..###..##.#.####..#..#..##..##......#..###..##.#...#####.#.#.#..##.#.####.#..###...#.......#...#......#...######
.#...#..####.#..#...####..#....#.###....##..#..###..#...#....####.#...#.###.####.#....#.##....##...####..###.#.#.....#.#.#..#.#.
....###..###.#.#.##.#.##.##.####.##.#.##.#..####.###....#...#.###...#..#..###.##.....##..#.#.##.##.##.....##.###.###..#.##.#####
.#..#####....#.####..###..######..#.###.#.###.##..##.#...####.#####..##.....#..####.....#.#...##.......#.......#.#.#..#...##.##.
###...#...#.#...##.##.####...#..###...#####..#.##..##..#.###.....#..#.#.#....######...######.#..##..#########.#.#....#...#.#...#
###..##.###.#...#......#....##...###.###...#####.#....####.#.###...##....#..#...##...#....##...##.....#..#######.#.#.#.#.###..#.
.#..#.###...###.#.....####.##.##.##..##..#.#.######......#....###..######...#.##...#.##.###......#..#.....###..###.#.#.#.#..#..#
#..###.#..........##.##..#.#..#....#...#.#..##..#..##.#.#..##.#..#.#....####.#.#...####..###..#..#.##.###.#.#.##.##.#.######.##.
..#.#..#.###..#.....###.##...#..#...#.##.#.##...######..#..####.###########...###...##.#..#..##.####.####.###.#.#####.....#...#.
#..#.#.###.##.#####..#..#.#########..#...###.##.##.#...#.##...##.##.#.##..##.#####.##.#########.#####..##.#####.####..#######...
...#####.#...#.##..#####.##..##.#.....#.#.#...######..#...#.#.#.###.#####.........##..#..####..#.#.###.#.#.##....#..#..#..##..#.
#####...#.#....#.#..#####.##..#..#..###..##.##.#.#......##..........#.##.##..#.##.#.....####..#####.#.#..#...###..###..##.#.###.
.#####....##..##..##......#..#.....#.#.###......##.#.#.##.#.#.#.###.###.#.#...##...####.###...###..#.##.#####.............#.####
...#....#..##.#.........#..#...#..#..###.##..###.#..#..........#..##.#.###..####.###..####..##.#.#...#..#.#........#..###.#....#
..##.##..#.##.##...##.##.#.##.##....#..#...###.##.#.#...#.....#..#.###..##.#.#.......##....#.##..##...##...#..##...###..###..###
...###........##.###..#...#...#.#..######.#......#...#.#.#####.#########..#####.#....#####..#.#....#####.#...##.#.#####...#...##
.##.#...#..###.###..#..#..##.....##.#..####...#....#####..##.##.#..###.#..######.###.....##...##.#####..##.#.##.##.......###.#.#
.##.##..####.###.#.......#.#.##..#.....##.#.#..#####....#.###.########.#.#..##.#.#.....#.#....##..##...##.#...#.###.#.#####..#..
#...##..###....#..#####....##......##.#....#.####..#.#..#.#...###.#..#..##..##..#..#...#.##.....###.###.#...##.#.###..#.#####..#
...###.#.........####..#..#.#.###.##.##.#.#..#.#.#..#.....###.#..#.###.#.#....#.#.#.#.###.#.#...###.##.#..##.####.#...#..#..#.#.
#.###.#....###....###..##..#.#########.####.#...###...##.#.####..####..#.##.#..#####..##..##.#....#...###.#..##..####.#.#...#...
..#.#..#......#.###.###.###.#.##.#.....###.#..###..#####.###..#.#..###..#..#....###..###.##.#.#.#.####.###.##..##.#.#..#...###.#
#...#.....###..#.##.##.##.#...#.##..#.#...#.##.####..##.####.##..#.#.#.#...###...##..#.#.#...#.###.#..###.#.#...##....#..#.##..#
.#......#...##........##.#..##.#####.##.###.###.#.#.##.####.#.#.#..#.###.##..#####.##..##..####.##..#.##.#.....#...#..######..##
#..##..####...##...##.##.##.#.##.####.##.#.#..###...##.#.#####.#...###.#.#####.#..#.#.##...##...#..########.#....#.....##.##.###
#.##.###.##....###...#.##...#.......##..###..#......####.####...#....#.#.#.###..##..#..#.##.#..#.####.##.##.#####..#..#######.#.
.#...##.###.....#..###..#...####..#.##..#.#.....#####.##.#....#..##..#..##..##...#..#..#.##.#.##..###.##.#.#...##..#.#.#####.#.#
.....##..#..#...#.##.#..#..###.....###....##.##..######.#.#...##.###.#..###...####.##..###...##.##.#..#####...#...#####....#.##.
...#..##...#.###..###..#.#...##.#..##..#....####..#.#..####...#.##.......###.#....#.#.#..##..#.#.#.#....##..##.#...#.#...#.#.#..
##.#.#.#...####.#..#..#..###.##.#.#..#...#.##...#.#.######...##.##....######.####.##.#.####.###.#......#.##...###..#...##.#..##.
......#.####..#.#######.###....##.#.##..#.#..#.##.....####.##...#.#.....#..#.###..##..###.#..#.#....##.#.#...##...#.##...####.##
#...##..#.###.##.##.#...##.#.##..###.##..###..###.#.##...#..######...##.#.##......#....###...#....##..#####..#.#..###.##...#...#
.#......##.....###..#....##.###.#..#..####...#.##...#....##.####..#.###...#########..#.#...##..#.#...#..###....#.#.##..##....###
#...#.#.#..#####...#...#.###....#######.#.#.#.##..###.....##.#..######.##.....#######.########.##.###..##...#.######..#.#..#.#.#
..#.#........#.###.####.##...#...######...###.......#.####.##..#.###..##.######.#.#.##.##.###.##.....###....##.###...#.#.###.###
#.#####..#######..#.##.#..#.##.########.#.###.#..#.....#######.#.##.#..##.#####.###..##..######.....#.#.####.###..##...##.###.#.
##..##.##.##.#.#..###.##.#...###.#....#.##........###.#.###.#.##.#..#....#.#.#.#....#.#.#.#...#.####..######..#.##.#......##..##
.#.##.###.#...##...##..#.##....##.####..#...#..#..#..#..#..##..##............###.##.##.#..##..###....##.#.##.##.#..###...#####.#
###.###.#..#...###..##.##.###.#.##.##..###..####..###.#.#...#####..#..##..###..##.#.###.######.###.#....#.##..##.#..#....####..#
.######.#.###..##......##.##....#..####.#.##..#..#..#...###.####..###.###.#######..#.#..##...##..##.#.....##.####...##...####...
##.#.##.#...###.....####.....#.....#.#.##.#..#.#####.#....#...###..##....#...#.##.####.###..#....#..#.###..##.###..#....##.###..
###..###..#.###...#.#....#.#...######.#.#.#..#..#...##..##....#....##.###....#.##.....######.#....#########......######.###.#...
.#.#.#..###.##.....#.#.##..###.......##...###...#..#..##.##....##...#.####.#...#...####.....###..#.#..#..#####..#....#.....###.#
........##.##...#......######..##.#.#####.###...####.#..#...###.##....###.#..##.#.####.##.#.#...####..##..#...###.#.#..###...#..
#.#.....#..####.#..#.###.#....#####.....#.###...#..#..##.##..#.#####.#.####..##...####.....#..#...#####.##.#.##...###.###.#.#.#.
##..##..##....################...###.#.####.....###....#.##..#.##..###..##..##..#.#...##.#..##..##...#.#.##..###..#####...#####.
#..#.#...#####.###.##.###.#..###.###....#..#..#.#..###...#.##..#...##.#.#.###..#..##.##..###.##...##..##..#..#.####....##.#..##.
#.##.#.#..#.#.###..#..#.#.#.##.##.#....#..#.#..#....#.#.#..#####.##...##..##...####...####..##.##.#..#.##..##..#...##...###..#..
.#...#...#.#...####..#.#..#.#....#..#....###......#.###.....#..##...#.###.#....##..##..####....#.#.##.###....####.###.######..#.
##.##.#####.#..######.......#...#....##..#....###...##.#.#.#.###..##..#.###..#..##.#..#..#.#.....###...#...##.......#.#####.#.##
##.##..#...###.#.####..#.#...#.#..##...##....#....#....####.#..#..###..###..####.##########....#..##.#....##....###.###......###
..#...#..#.###.#.##.#...##.##.##.#####.#..##.#....#.#.#.##.#..##.###..#.##.#.......####.#.#....#.#.........#####.#...##..####...
###.##.##..#.##.#.#.#...#.####..####..######.###.#.###.###..#...#.#..##.....###..#####....##..###.#..##..#...###..########...###
.#####.#.#..#.##..###.#####......#.#.....###.#...##.##..#..#...#...#..#####.#####..#.....##..#....#.##..#...#...#..#.###....####
#........#....#.#..##.....####.######...##.###..#....#...#.#.#....#......#..#...###.#..#..#.##..##.###..###.###.##...#.###..#..#
.##.####...#.#####..##....##.#..#.#...#....#.#.#..##.#....#####.#.##.#.##.#.###..#..#.###.##.....###.....####..#.#....###..#.###
.....####..#.#.#..#.##.....#.......#.#.##.##...##.....####......#.#..####.###.#....##..######.#..#.###..##..#.#..#..##...##.##.#
